World: 25 Push Mushroom trough Tunnel 
X: 20
Y: 9
########    ########
#@     #    #      #
#      #    #      #
#      ######      #
#                  #
#      ######      #
#      #    #  $   #
#.     #    #      #
########    ########
