World: 22 Kara in a Box I 
X: 9
Y: 9
#########
#+ .... #
#. .  . #
#. .. . #
#. .  . #
#... ...#
#. .... #
#... ...#
#########
