World: 15a Round Trip 
X: 10
Y: 10
##########
## @    ##
## #### ##
##. ##  ##
### ## ###
### ## ###
##  ##  ##
## #### ##
##      ##
##########

World: 15b Round Trip 
X: 10
Y: 10
Kara: up
##########
#   ######
#@#  #####
# .#  ####
##  #  ###
###  #  ##
####  #  #
#####  # #
######   #
##########

World: 15c Round Trip 
X: 9
Y: 9
#########
####    #
#  @ ## #
# ##### #
# ####  #
#  ### ##
## #   ##
## . ####
#########

